1111111
10000P1
100C001
1000001
1C00001
1111111