111111111
1000C0001
101110101
1P0010E01
111010101
1C0000C01
111111111
